A	aaa
B	aac
;	aag
C	acc
D	agc
E	agg
F	agt
G	atc
H	caa
I	cac
J	cat
K	cca
L	ccc
M	cgc
N	cgg
O	cgt
P	cta
Q	ctc
R	ctg
S	ctt
T	gaa
U	gac
V	gag
W	gat
X	gcc
Y	gct
"	gga
Z	ggc
>	ggg
(	ggt
@	gtc
#	tag
$	tat
%	tcc
^	tgc
&	tgg
<	ttg