A	AAG
B	ACC
;	ACG
C	ACT
D	ATA
E	ATC
F	ATG
G	CAA
H	CAG
I	CCA
J	CCC
K	CCG
L	CCT
M	CTA
N	CTT
O	GAC
P	GAG
Q	GAT
R	GCA
S	GCC
T	GCG
U	GCT
W	GGC
X	GGG
Y	GGT
<	GTC
Z	GTG
>	GTT
(	TAG
@	TCC
#	TTC
$	TTG
%	TTT
*	AAA
a	AAC
b	AAT
c	ACA
d	AGA
e	AGC
f	AGG
g	AGT
h	CAC
i	CAT
j	CTC
k	CTG
l	GAA
m	GGA
n	GTA
o	TAA
p	TAC
q	TAT
r	TCA
s	TCG
t	TCT
u	TTA
v	TGA
w	TGC
x	TGG
y	TGT
z	CGT
[	ATT
{	CGA
:	CGC
+	CGG
